12 11
############
#o#........#
#.#.######.#
#.#...*#...#
#.########.#
#...#...#..#
#.#.#.#.#..#
#.#.#.#....#
#o#.#.#.#...
###...#.#...
#####...####