50 50
##################################################
###.#.#.#.#.#.#.#.#.#.#.#.#.#.#.#.#.#.#.#.#.#.#.##
###.#.#.#.#.#.#.#.#.#.#.#.#.#.#.#.#.#.#.#.#.#.#.##
#.....#.#.#.#...#.#...#...#.#.#.#.#.#.....#.#.#..#
#####.#.#.#.###.#.###.###.#.#.#.#.#.###.###.#.#.##
#...#.#.......#...#...#.#.#...#.#.....#...#.#.#..#
###.#.#.###.###.#####.#.#.#.###.#.#.#####.#.#.#.##
#.....#.#.....#.....#...#.....#.#.#.#.#.....#..*.#
###.#####.###.###.#.###.###.###.#.###.###.###.####
#.........#.......#...............#.#.#...#.#....#
###.###.#################.###.#.###.#.#.###.#.####
#.....#.#.....#.#.#...#.#.#...#.#.#...#.#.#.#....#
###.#########.#.#.#.###.#.###.###.#.###.#.#.#.####
#...#.#...#.......#.#.#...#...#.#.............#..#
#####.###.###.###.#.#.#######.#.#.###########.#.##
#...#.........#.#.......#.#.#.....#...#.....#....#
###.#.#####.#.#.#####.###.#.#.#####.#######.######
#...#.#.#.#.#.#.......#.....#.#..................#
###.###.#.###########.###.###.#.#######.#.#####.##
#.....#.....#.#...#.#.........#.#...#...#...#....#
###.#.#.#####.###.#.#.###.#####.#.#######.########
#...#.#.#.#.#...#...#.#...........#...#.....#....#
#####.#.#.#.###.###.#####.#########.#########.#.##
#...........#.#.#.......#.........#.......#...#..#
###########.#.#.#######.#.#.###.###.###.###.######
#...#...........#.#.......#...#.......#..........#
###.###.###.#.#.#.#######.#.###.#.#.###.#####.####
#.......#...#.#...........#.#...#.#.#.#...#......#
###.#.###.###.#.###.#####.#.###.###.#.#####.######
#...#.#.....#.#...#.#...#.#...#.#.#.....#.#.#....#
###.#.###.###.#########.#.#######.#.#####.###.####
#...#.#...#...#...#.#.............#...#..........#
#####.#######.###.#.#####.###.#.###.#.#.#.###.####
#.....#.......#...........#.#.#...#.#...#.#......#
#################.#######.#.#.#########.#####.####
#.......#.........#.#.#.....#.......#.....#.#....#
#######.#.###.#.#.#.#.###.#.###############.#.#.##
#.........#...#.#.#.......#.................#.#..#
#####.###.#####.#.#.#.#.#####.###.#.#.###.#.###.##
#.......#.#.....#.#.#.#...#.#.#...#.#.#...#...#..#
#######.#.#######.#########.#####.###.#######.####
#.......#...#...#.....#...........#.#.#...#.#....#
#####.###.###.#o#.###.#.###.#####.#.#####.#.######
#.....#...#.#.#.....#.#.#...#.#...........#...#..#
#####.#.###.#####.#####.#.###.#.#.###.#####.#.#.##
#.....#.#...........#.#.#.#.....#...#.......#....#
###.#.#.#####.###.###.###.###.###.#.#.#.###.#.####
#...#.#.#.....#...#.........#...#.#.#.#...#.#....#
###.#.#.#.#.#.#.#.#.#.#.#.#.#.#.#.#.#.#.#.#.#.#.##
##################################################
