100 100
####################################################################################################
##.#.#.#.#.#.#.#.#.#.#.#.#.#.#.#.#.#.#.#.#.#.#.#.#.#.#.#.#.#.#.#.#.#.#.#.#.#.#.#.#.#.#.#.#.#.#.#.###
#........#.#.#.......#.............#.....#.#.#.....#.....#.#...#.#.#.#...#...........#.......#.#...#
##.###.###.#.#######.#.#####.#######.#####.#.###.#.###.###.#.###.#.#.#.#####.###########.#####.#.###
#..#...#...#...#...#...#.#...............#...#.#.#.#.......#...#.................#...#...#.#.......#
######.#.###.#####.#####.#.#######.#.#####.###.###.#####.###.#.#.###################.###.#.#####.###
#..#.......#.#...#...#.#.#...#...#.#.#.#.#.#...#.#.#...#.#...#...#.....#...#.#.#.#.#.#.#.#.#.......#
##.#######.#.#.###.#.#.#.#.###.#######.#.#.#.###.#.###.#.#####.#.#.#####.###.#.#.#.#.#.#.#.###.#####
#....#...#.#.#.#...#.......#.#.#.#.#.#...#...#.#.#.....#...#...#.............#.....#.....#.#.......#
##.###.###.#.#.#########.#.#.#.#.#.#.#.###.###.#.#####.#.#####.#.#.#####.#######.#.###.###.#.#######
#....#.#.......#...#.#.#.#...#.....#.#.....#.#...#.#.#.....#.#.#.#.#.#.#.#...#...#.#.#.#...#.......#
####.#.#######.###.#.#.###.#.#.#####.###.###.###.#.#.#.#.###.###.###.#.###.#####.###.#.###.#.###.###
#..#.#...#.#...#.......#...#...#.#.......#.#...#.#...#.#.#.....#.#.......#...#.#...#...........#...#
##.#.###.#.###.###.#.#.#####.#.#.###.#####.#.###.###.###.#####.#.#.#######.###.###.###.###.#####.###
#....#...#.#.....#.#.#...#...#...#.#...#.....#...#.#.....#.......#.......#.........#.#...#...#.#...#
##.#.#.###.#####.#######.#####.###.#.#####.#####.#.###.#######.###.###########.#.###.#.#.#.###.#####
#..#.#.#.#...#.#.#.#.#...#.#...#.#...#...#.#.#...#...#.#...........#.......#.#.#...#...#.#...#.#...#
##.###.#.###.#.#.#.#.###.#.###.#.#.#.#.###.#.#.#####.#.#########.###.###.###.#.#####.#########.#.###
#....#.#.#.#...#.......#.........#.#...#.......#.#.#.#.....#.#.#.#.#...#.#.#.....#...#.#...#.......#
##.###.#.#.#.#######.###########.#####.###.#####.#.#.#####.#.#.#.#.#.#####.###.#####.#.#.###.#######
#......#...#.#.#.#.#.....#.....#.#...........#.#.....#...#.#.#...#.....#.#.#...#.#...#.#.#.........#
##.#######.#.#.#.#.###.#######.#.###.#.#####.#.#.#######.#.#.#.#.###.#.#.#.###.#.###.#.#.#.#####.###
#....#...#...#.....#.#.#...#...#...#.#...#...#...#...#.#.#.#...#...#.#.#.#.#.#.#.#.#.........#.#...#
##.#####.#.#.#####.#.#.###.###.#.###.#####.###.#####.#.#.#.#.#########.#.#.#.#.#.#.#.###.#.###.#####
#..........#.#...#.....#.....#.....#.#.#.#.......#.#...#.#.#.....#...#...#.#...#.#.#.#.#.#.#...#...#
####.#.###.#####.###.#.#####.###.#####.#.###.#####.###.#.#.#.#######.#.###.###.#.#.#.#.#####.###.###
#....#.#.#...#.....#.#.....#.#.......#...#.#.#.#...#.....#.........#.#...#...#.......#.#...#.......#
######.#.###.###.#######.###.###.#.###.###.#.#.###.###.###.#########.###.#.#####.###.#.#.###.#######
#....#.#.....#...#.#.#.......#...#.#.#.....#.#.........#.#.........#.#.....#...#...#...........#...#
##.#########.###.#.#.#####.#####.###.#####.#.#########.#.#.#.#.#.###.###.###.###.#.###.###.#.#.#.###
#..#...#.#.........#.......#...#...#.#...#.#.#...#.#.......#.#.#.#...#.........#.#.#.....#.#.#.....#
##.#.###.#####.###.#######.###.###.#.#.###.#.###.#.#####.###########.#.###.#####.###.#########.#.###
#....#...#.....#.........#...#.#.#.#...#...#...#.....#.#...#...#.#.......#.......#...........#.#...#
##.#####.#####.#.#.#.#.#.###.#.#.#.###.###.#.#.#.#####.#.#.###.#.#####.#######.#######.#####.###.###
#..............#.#.#.#.#.#...#.#.#.#.#.....#.#.#.....#.#.#...#...#.#.#.....#.......#.......#...#...#
##.#.#.#.#.#.#####.#####.###.#.#.#.#.#####.###.#.#####.#.#######.#.#.#.#######.###.###.#####.#.#####
#..#.#.#.#.#.#.....#.#.....#.......#.#.....#.#.......#.....#.#...#.......#.#.#...#...#.#...#.#.....#
##.#.#####.###.#####.#####.#####.###.###.###.#####.#####.###.###.#.###.###.#.#.#####.#.#.#.#.#.#.###
#..#.#.....#.#.#.........#.....#...#...#...#.#.#.#...#.....#.#.#.....#.......#.#...#.#...#.#.#.#...#
############.#######.#.#.#.###.#.###.###.###.#.#.#.###.#.###.#.#.###############.###################
#......#.............#.#...#...#.#.....#...#...#.....#.#.....#...#...#...#...#.#...#.......#.......#
##.#.#########.#.#############.#.###.###.#####.###.#######.###.###.#####.#.###.#.###.#.###.#.###.###
#..#.#...#.#...#.#.....................#.....#.....#.#.#...#.#.#.............#.#...#.#...#.#...#...#
####.###.#.#####.#############.###.###.#.#######.###.#.#.###.#.#.###.#.###.###.#.###.#######.#######
#............#...#.............#.#...#.#.....#...#.#.............#...#...#...#.#...#...#.#.#.#.#...#
##.#########.###################.#####.#####.#.###.#.#######.###.#.#.#####.###.#.###.#.#.#.#.#.#.###
#....#.....#.#.......#...#...#...#.#.#.#...#...#.#.......#.....#.#.#...#.#...........#.............#
######.###.#.#######.###.#.#####.#.#.#.###.###.#.#.#####.#########.#.#.#.###.#.###.#######.#####.###
#..#.....#.#...#.#.........#...#.........#.......#.....#.....#...#.#.#.....#.#...#.......#.....#...#
##.###.###.#.###.###.#.###.###.###.###.#######.###.#.#####.#.#.#####.#.#####.#.#.#############.#.###
#......#...#.#.....#.#.#.........#.#.#...#.........#.....#.#.....#...#.#...#.#.#...#.#.#.....#.#...#
##########.#.#.###.#######.#.#.#.#.#.#.#.###.#.###.#####.###.#############.#########.#.#.###########
#......#.#...#.#.#...#.....#.#.#...#.#.#.....#.#.......#.#.........#...#...........#...#.#.#.#.#...#
######.#.###.###.#.#.###.###.###.###.###.#.#####.#.#####.#####.#.#####.###.#.#.#####.#.#.#.#.#.#.###
#..#.....#...#.#.#.#.#.#.#...#...#.......#...#.#.#.#...#.#...#.#...........#.#.......#.......#.....#
##.###.###.###.#.###.#.###.###.###.###.#.#.###.#.#.#.#####.#.#.#####.#.#.#.#.#################.#####
#..#...........#...........#...#.#.#...#.#...#...#.........#.#.#...#.#.#.#.#...#.....#.............#
##.#.#.#.#####.#.#.#.#.###.#####.#.#.#.###.###.#.#.#############.#####.#.#######.#####.#.#.###.#####
#..#.#.#.#.......#.#.#.#...#.......#.#.#.....#.#.#.....#.............#.#.....#.........#.#...#.....#
##.#####.#####.###.###.#####.###.#####.#.###.#####.#####.#####.#.#####.#.#####.###.#########.#.#####
#......#.#.....#...#...#.....#...#.....#...#.#.#.#.........#.#.#.....#.#.........#.#.#...#.#.#.....#
######.#.#.#.###.#.#.#.#############.#######.#.#.#.#.#.#.###.###.#.#######.#.#######.#.###.#####.###
#........#.#...#.#.#.#...#.........#.#.#.#...#.....#.#.#.......#.#.#.....#.#.........#.........#...#
######.###.#.#.#.#################.###.#.#####.#.#.#.###.#.###.###.#.###.#.###.#####.#.#######.#####
#......#...#.#.#.#.............#...............#.#.#...#.#...#...#.....#.#.#.....#...........#.....#
##.###.#.###########.#####.#.#.###.#.#.#.#.#######.###.###.###.###.###.#######.#####.###.#####.#####
#..#...#.#...........#.....#.#.....#.#.#.#.#.........#.#.#...#.#.....#...#.#.#.....#...#.....#.....#
####.#######.#.###.#.#########.###.###.#.#####.###.###.#.#################.#.###.#.#.#.#############
#......#.....#.#...#.....#.....#...#...#...#...#.....#.......#.#...#...#...#.#...#.#.#.............#
####.#.#.#.#.#.#.#.#.###########.#.###.#.#.#.###.###.###.#####.#.#####.#.###.#####.#.###.#####.#####
#....#.#.#.#.#.#.#.#.#.#.#.....#.#.#...#.#.#.#.#.#.#.#.........#...#...........#.#.#...#...#.......#
##.#######.#####.#####.#.#####.#######.#.#.###.###.#.#########.#.#####.#.#######.#######.###.#######
#....#.#.#.#.....#...#.................#.#.#.............#.#.#...#.#...#.#.#.....#.#.#.#*#.........#
####.#.#.###########.#.#.#######.###.#.#.#######.###.#.###.#.#.###.#.#.#.#o#.#####.#.#.#####.#.#####
#....#.................#.#.........#.#.#...#.......#.#.......#.....#.#.#.....#.............#.#.....#
######.#.#.#######.#.#####.#####.###.#####.###.#####.#####.###.#.###.#########.###########.#########
#..#...#.#...#.....#...#.....#...#.....#...#...#.......#.....#.#.......#...............#.#.#.#.....#
##.#.#.###.###.#.###.###.#.#####.###########.#.#.#.#########.###.#.###.###.#.###.#.#.###.###.#.#####
#....#...#.#...#.#...#.#.#.#...........#.....#.#.#.....#.......#.#...#.....#...#.#.#...........#...#
########.#.#.#.###.###.#######.#########.###.###.#.###.#.#.###.#####.#####.###.#.#.#########.#.#.###
#........#.#.#.#.#.#.................#.....#.#...#...#.#.#...#.....#...#...#.#.#.#.......#.#.#.....#
####.#########.#.#########.#####.#.#.#.###.#######.#####.#.#.###.###.#####.#.###.###.#####.#########
#....#...#.....#...#...........#.#.#.#.#.#.#...........#.#.#...#...#.....#.....#.#...........#.#...#
########.#####.#.#####.#.###.###.###.###.#.#.###.#.#.#.#######.#######.#####.###.###.###.#####.#.###
#..............#.#.#...#.#.....#.#...#.#.#.#.#...#.#.#...#.........#.......#...#...#...#.#...#.....#
########.#.#.#.#.#.###.###.#.#######.#.#.#.#.###.#.###.#####.###.###.###.#.#######.#####.#.###.#####
#........#.#.#.#.......#...#...#.....#.....#...#.#.#.#.#...#.#.#...#...#.#.#...#.#.....#...........#
######.###.#####.#.#.#.#####.#.#####.###.#.#.###.###.#####.#.#.#####.#####.#.#.#.#########.#.#######
#..#...#.#.#.#...#.#.#.....#.#...#...#...#.#.#.#.....#.#.#.......#.......#...#.....#.#.....#.......#
##.#####.###.###.#.###.###.#######.###.###.###.###.###.#.#.#.#.#####.###.###.#####.#.#.#####.###.###
#................#.#.....#.#.......#.....#.....#...#.......#.#...#.#...#...#...#.....#...#...#.....#
########.#####.#####.#####.#.#####.#.#####.#############.#.#####.#.#.#.#.#.###.#.###.#.#.#####.#.###
#....#.#.#.....#...#.....#.#...#...#.#...........#.......#.#...#...#.#.#.#...#.#.#...#.#.#.....#...#
##.#.#.#.#.#.#.#.#.#.#####.#####.#.#####.#.#.#.#.#####.#.#.#.#####.#.#.###.#.###.###.#######.###.###
#..#.....#.#.#.#.#...#.....#.....#.#.....#.#.#.#...#...#.#.....#...#.#.#...#.#.....#.#.#...#.#.....#
####.#.###.###########.#.#.#####.#######.#.###.#.#####.###.#.#########.#####.###.###.#.#.#.#.###.###
#....#...#.#...........#.#...#...#.......#...#.#...#...#...#.........#...#...#...#.......#.#...#...#
##.#.#.#.#.#.#.#.#.#.#.#.#.#.#.#.#.#.#.#.#.#.#.#.#.#.#.#.#.#.#.#.#.#.#.#.#.#.#.#.#.#.#.#.#.#.#.#.###
##.#.#.#.#.#.#.#.#.#.#.#.#.#.#.#.#.#.#.#.#.#.#.#.#.#.#.#.#.#.#.#.#.#.#.#.#.#.#.#.#.#.#.#.#.#.#.#.###
####################################################################################################
