12 10
############
#o#........#
#.#.######.#
#.#.#..#...#
#.###**#.#.#
#...####.#.#
#o#.#....#.#
#.#.#.##.#.#
#.#.#.##.#..
###......#..