50 100
##################################################
###.#.#.#.#.#.#.#.#.#.#.#.#.#.#.#.#.#.#.#.#.#.#.##
#...#.......#...........#.....#.#.#.....#.#...#..#
###.#####.###########.#####.###.#.#####.#.#.###.##
#...#.#.......#...#.#...#.......#...#.....#.#....#
###.#.###.#####.###.#.#.###.#####.#.#.#.#.#.###.##
#.....#...#.......#...#.#...#.#.#.#.#.#.#.....#..#
###.#####.###.###.#####.#.###.#.###.#######.###.##
#.....#...#...#...#...#.....#.#.#.#...#.#........#
###.#.###.#######.#.#####.#.#.#.#.#.###.#####.#.##
#...#...#...#.......#.....#.....#...#.#.....#.#..#
#######.#.#########.#####.#######.###.###.#.###.##
#.....#.#.#.#.......#...#...#.#...#.#...#.#.#.#..#
#####.#.#.#.#######.###.#.###.###.#.###.###.#.#.##
#...#.....#.#...#.#...#...#...#...#.......#.#....#
###.###.###.###.#.#.#.#.###.#.#.#####.#####.###.##
#...#...#.......#.#.#.....#.#.#.#...#.#.......#..#
###.#.#####.#.###.#######.#.###.###.#.#####.###.##
#...#.#...#.#.#.....#.#...#.#.#.....#.#..........#
###.#.#.#####.#####.#.###.#.#.###.###.#.#####.####
#...........#.#.#.#.#.......#.........#.#.#.#....#
###.#########.#.#.#.###.#######.#######.#.#.######
#...#.#.#.....#.#...........#.#.#...#.#.#...#.#..#
###.#.#.#####.#.#######.#####.#.#.###.#.###.#.#.##
#...#.#.#.......#.#.#.#.#.#.#.#.#.....#.....#....#
###.#.#.#######.#.#.#.#.#.#.#.#.#.#######.###.####
#...#...#.#...#.#...#.#...#.........#.#.#........#
###.###.#.###.#.###.#.###.###.#####.#.#.###.######
#...#.......#.#...#...#.#.#.#.....#.#.#.........*#
###.#######.#.#.###.###.#.#.#.#.#####.###.########
#.....#.#...#...#.#.....#...#.#.#...#.#.#...#....#
###.###.###.###.#.#.#.#.#.###.###.###.#.#.###.####
#.....#.#.#.#...#.#.#.#...#...#.#...#.#.#.#......#
#####.#.#.#.###.#.#####.###.###.#.###.#.#.###.####
#...#.#...#...#.#...#...#.#.....#.#.......#.#.#..#
###.#.#.#####.#.#.###.###.#.#####.###.#.###.#.#.##
#.........#.........#.#.........#.#...#.#.#......#
#########.#########.#.###.#######.###.###.#.#.####
#...........#...#.............#.#.#.....#.#.#....#
###.#######.###.#####.#.#####.#.#.###.###.#.######
#...#.#.#.#...#.#.#...#.....#.#...#...#.#........#
#####.#.#.###.#.#.###.#########.###.#.#.#.#####.##
#...#.#...#.......#.#...#.#...#.#...#.#.......#..#
###.#.###.###.#.###.#.###.###.#.#.#####.##########
#.....#.......#...#...#.#.#.#.#...........#...#..#
###.###########.#####.#.#.#.#.#.###.#.###.###.#.##
#...#.#.#.#.#.....#.....#.#...#...#.#.#.......#..#
###.#.#.#.#.###.#.#####.#.#.###.###############.##
#...............#.....#.#...#...#.....#.#........#
###########.#####.#.#.#.#.###.###.###.#.#.#.#.#.##
#...#...#...#.....#.#...#.#...#.....#.....#.#.#..#
###.#.###########.#.#.#.#.#.#.#.#.#.#####.#.#.#.##
#.........#.#.....#.#.#.#...#...#.#.....#.#.#.#..#
###.###.###.#####..####.#.#####.###.#.#.#.###.####
#...#.......#...#.#.........#.#...#.#.#.#.#......#
#########.#####.#######.###.#.#.#.#.#########.####
#...........#.#.#...#.....#...#.#.#.#............#
#########.###.#.###.#.#.#.#####.#.###.#####.#.####
#...........#.#.#.....#.#.....#.#.........#.#....#
###.#####.###.#.#####.#.#.#####.#.#####.#.###.#.##
#...#.................#.#.....#.#.....#.#...#.#..#
#########.#####.#####.#####.#####.#.###.###.###.##
#.............#.#.#.....#.#.....#.#...#.#.#...#..#
###.#.###.###.###.###.#.#.###.###.#####.#.###.####
#...#.#...#...#.......#.....#...#.....#...#.#.#..#
###.#############.#.###.###############.###.###.##
#.........#.......#.#.........#.#.#..............#
###.#.###.###.#####.###.#.#####.#.###.#.#.########
#...#...#.#...#.....#.#.#...#.......#.#.#........#
###.#.#####.#.#####.#.#.#.#.#.#####.##############
#...#.#.....#.#...#.#...#.#.............#........#
###.#.#####.#####.#.###.#####.#.#.###.#####.######
#...#...#.#.#.......#.......#.#.#...#.#.#........#
###.#####.###.#.#.#.#.#####.#.#######.#.#.########
#...#...#.....#.#.#.#.....#.#...#...#...#.....#..#
#####.###.###.###.###.#.#.#.#####.#####.###.###.##
#...........#.#.....#.#.#.#...........#..........#
#######.#####.###.#.#.###.#.###.#.#.###.#####.#.##
#.........#...#.#.#.#...#.#...#.#.#o..#.....#.#..#
###.###.###.###.#.#.#.###.###.#.#####.#.#.###.####
#...#.....#.#.....#.#...#.#...#.....#.#.#...#....#
###.#.#.#####.#.###.#.###.#####.#.#.#####.###.####
#...#.#.#.....#...#.#...#.#.....#.#.#.#.....#....#
#######.###.###.#.#.#.#######.#.###.#.###.#.#.####
#.........#.#...#.#.#.....#...#...#...#...#.#....#
#######.###.###.#####.#.#####.#.###.#####.#.#.#.##
#.........#.#...#.....#.#.....#...#...#.#.#.#.#..#
#####.###.#.#####.#.#####.###.#.###.###.#.#.#.####
#.......#.#.#.....#.#.#.....#.#...#.#...#.#.#....#
#####.#.###.#.#.#####.#.###########.#.###.########
#...#.#.#...#.#.#.........#...........#..........#
###.#.###.###.###.###.#.###.###.###.#.#.###.###.##
#.......#.#...#...#...#...#.#.....#.#.#...#...#..#
###.#.#######.#.#.#.#.#####.###.#.###.#####.#.#.##
#...#.......#.#.#.#.#.#.....#...#...#...#...#.#..#
#####.#########.#.#.#.#####.#.#.#####.#.#.#.###.##
#...........#...#.#.#.#.....#.#.....#.#.#.#...#..#
###.#.#.#.#.#.#.#.#.#.#.#.#.#.#.#.#.#.#.#.#.#.#.##
###.#.#.#.#.#.#.#.#.#.#.#.#.#.#.#.#.#.#.#.#.#.#.##
##################################################
