50 150
##################################################
###.#.#.#.#.#.#.#.#.#.#.#.#.#.#.#.#.#.#.#.#.#.#.##
###.#.#.#.#.#.#.#.#.#.#.#.#.#.#.#.#.#.#.#.#.#.#.##
#.........#.#.....#...#.....#.......#.#.#...#....#
#####.#####.#####.###.###.#####.#####.#.#.#####.##
#.......#.....#.....#.#.....#...#.......#...#....#
#####.#######.#####.#.###.###.#.#######.#.###.####
#...#...#...#.#...#...#...#.#.#...#...#.......#..#
###.###.###.#.###.###.#.###.#####.#.###.#######.##
#.......#...........#...#...#.....#...#.#.#......#
#####.#.#######.#.#####.#.#######.#.###.#.#.#.#.##
#.....#.#.....#.#.#.......#.#.#.....#.#...#.#.#..#
#######.###.#.###.###.#####.#.###.###.#.###.###.##
#.....#.#...#.#.#...#.#.....#.......#...#...#.#..#
#####.#o#####.#.#.#.#.#.#######.#.###.###.###.####
#.....#...........#.#.......#...#.#.....#.....#..#
#####.###.#.#.#.#.#.#.#.#########.#.#####.#####.##
#.....#.#.#.#.#.#.#...#.....#.#...#.#.#.#...#....#
#####.#.#######.#.#.#.#######.#.#.#.#.#.#.#####.##
#...#.#...#.#.#.#.#.#.#.#.#...#.#.#...#..........#
###.#.#.###.#.#######.#.#.#.#####.#.###.##########
#.....#.......#.........#...#.#...#.#.#.#.#.#.#..#
###.#####.#############.###.#.###.#.#.#.#.#.#.#.##
#.....#.#.#...#.#.....#.#...#.........#.#.#.#....#
###.###.#.###.#.#####.#.#.#####.###.#.#.#.#.#.####
#...............#.#...............#.#.#.#.....#..#
###########.###.#.#####.###.###########.#.#####.##
#...#.#.#.#.#.#...#.#.#.#.#.#.......#.......#....#
###.#.#.#.###.###.#.#.#.#.#####.#######.###.#.####
#.............#.#.#.#.#.#.#.#.#.#.#.#...#.#.#....#
#######.###.###.#.#.#.#.#.#.#.#.#.#.#####.#.#.####
#.......#...#...#...#.#...#...#.#...#.#.#.#.#....#
#####.###.#.###.###.#.#.###.###.#.###.#.#.#.#.#.##
#...#...#.#.....#.#.#...#.#...#.#...#.........#..#
###.#####.#####.#.#.#.###.###.#.#.###.#.###.######
#.......#.#.#...#...#.#.#.#...........#...#.#....#
#####.#####.###.###.#.#.#.###.###.###.#.#####.####
#.......#...........#.#...#.....#.#...#.#.....#..#
#####.#####.#.#.###.#.###.###.#####.#####.#.###.##
#...#...#...#.#.#.#...#...#.....#.#.#...#.#...#..#
###.###.#.#######.#.###.#.###.#.#.###.#####.###.##
#...#...#.#.#...#.......#.....#.........#.....#..#
###.###.###.#.###.#.###.###.#.#####.#######.###.##
#...#.#.#...#...#.#.#.#...#.#.#...#.#.#...#......#
###.#.#.#.#####.###.#.#########.#####.#.###.######
#...#.#.#.......#.....#.....#.#.....#............#
###.#.#.#######.###.###.#####.###.###.#######.####
#.......#.#...#.#.#.#...#.#.#...#...#.#...#.#....#
#######.#.#.###.#.#.#.###.#.###.#.#.#.#.###.######
#.....#...#.#.#.#.#...#.#.#.#.#.#.#.......#...#..#
#####.#.###.#.#.#.#.###.#.#.#.#.###.###.#####.#.##
#.......#.........#.........#.....#...#...#......#
#####.#.#######.###.#.#.#####.#####.###########.##
#.....#.....#.......#.#.#...#.#...#.#.#...#.#.#..#
###########.###.#########.###.#.###.#.#.###.#.#.##
#...#...#.#.....#.#.......#.#.......#...#...#....#
###.###.#.#####.#.#.#######.###.#######.#.###.####
#...#.#.....#.....#.#...#...#.#.#.....#..........#
###.#.#####.###.###.#.#####.#.#.###.#####.#.###.##
#.....#.....#.........#.....#.....#.#.#...#...#..#
#####.#####.#####.#########.#.#####.#.###.########
#...#.....#.....#...#.#.....#...#.#.#.....#.#.#..#
###.###.#####.###.###.###.#####.#.#.#.#####.#.#.##
#...#.#.#...#...#...#.#.....#.#.#.#.........#.#..#
###.#.#.#.#.###.#.###.###.###.#.#.###.###.#.#.#.##
#.......#.#...#.#.#...#.#.#.#.#.#.......#.#...#..#
#######.###.###.#.###.#.#.#.#.#.#.###.#.#.#####.##
#...#.#.....#.#.#.#.#.#...#.#.#.#...#.#.#.#.#....#
###.#.#####.#.#.#.#.#.###.#.#.#.#.#.#######.###.##
#...#.......#...#.#.#...#.....#.#.#.#...#.#.#....#
###.#####.#####.#.#.###.###.###.#.#.###.#.#.#.####
#.....................#.#.#.#.#.#.#.#............#
#########.###.#.###.###.#.#.#.#.#.###.#####.#.####
#...#.....#...#.#.......#.#.....#.........#.#.#..#
###.###.#####.###.#.###.#.#.#####.#.#####.#.###.##
#.........#.#.#.#.#.#.............#.#...#.#.#....#
###.#####.#.###.#.#.#.#.#.#.#####.###.#######.####
#...#.......#.....#.#.#.#.#.....#................#
###.#####.#####.###.#.#.#.###.#.#.#######.#.#.####
#...#.....#.#.....#.#.#.#.#.#.#.#.......#.#.#....#
#####.###.#.###.###.#####.#.###.#.###########.#.##
#...#.#...#.......#...#.......#.#...........#.#..#
###.###########.###.###.#.#.#.#.#.###.###.#####.##
#.........#.#.#...#...#.#.#.#.#.#.#.....#.....#..#
#####.#.#.#.#.#####.#####.#.#.#.#####.#####.#.####
#.....#.#.......#...#...#.#.#.#...#.#...#...#....#
###.#####.#.###.###.#.#########.#.#.#######.#.####
#...#.....#.#...............#...#.........#.#....#
#########.###.###.#.###.###.#.#.#.#.#.###.#####.##
#...#.....#.....#.#.#...#...#.#.#.#.#...#.....#..#
###.###.#########.###.#.#####.#.###.###########.##
#.......#...........#.#...#.#.#...#...........#..#
###.###.#####.#.###.###.#.#.###.###.###.#####.#.##
#...#.....#.#.#...#...#.#...#.....#...#.....#.#..#
#########.#.#.#.#######.#########.#.#####.###.#.##
#.........#...#...#.............#.#.#.......#.#..#
#####.###.#######.###.#.###.###.###.#####.###.####
#.......#.#.........#.#.#.#...#...#.#.......#....#
#######.#########.#####.#.#.#######.#.###.#.###.##
#.........#.........#.....#.......#.#.#...#...#..#
#####.#####.###.###.#.#.#.#.###.#####.#.#.#.#.####
#...#.#.....#.....#.#.#.#.#.#.......#.#.#.#.#....#
###.#########.#.###.#.#.#########.###.#.#####.#.##
#...........#.#...#.#.#.#.#...#.....#.#...#.#.#..#
###.#####.#.#.#.###.###.#.###.###.#######.#.#.####
#...#.....#...#.#.#.#.#...#.#...#.#.....#...#....#
###.#####.#.#.###.###.#.###.#.#####.###.###.#.#.##
#...#...#.#.#...#...................#.#...#.#.#..#
#######.#.###.#######.###.#######.#.#.###.#.#.#.##
#.........#...#.#.....#.......#...#.....#.#.#.#..#
###.#####.###.#.#.#.#.#.###*#.#.#.#.#####.#####.##
#...#.....#...#...#.#.#.#...#.#.#.#...#.#.....#..#
#####.#.#######.#.#.###.###.###.###.###.###.######
#.....#.#.......#.#...#.#...#...#.....#...#......#
#######.#.#.#.#####.#.#.#.#########.#.#.#.#.#.####
#.......#.#.#.#.....#.#.#.......#...#...#.#.#....#
###.#.###.###.#########.###########.###.##########
#...#...#.#.....#.................#.#............#
###.#######.#.#######.#.#####.#.#.###.#.#.###.#.##
#...#.#.....#.....#...#...#...#.#.#...#.#...#.#..#
#####.#.#.###.#####.#.#####.#.#.#.#####.###.#.####
#.......#...#.#...#.#...#...#.#.#.#.#.....#.#....#
#############.#.###.###.#.#.###.###.###.###.###.##
#...#.#.#...#...#.....#.#.#.#...#.......#...#....#
###.#.#.###.#.#.#.#########.#####.###.#.#######.##
#.........#...#.#.........#.#.....#...#.......#..#
#######.###.#.###.###.###############.###.#####.##
#.........#.#...#.#...#...............#.......#..#
###.###.###.#####.###.#.###.#.#####.#.#.#.###.####
#...#...........#...#.#...#.#.#.....#.#.#.#......#
#######.###.#.###.#.###.###.###.#.#####.#####.#.##
#.......#...#.#...#.#.#...#...#.#...#...#.....#..#
#####.#.###.#####.###.###.#.#.#.###.#####.#.#.#.##
#.....#...#.#...........#.#.#.#.#.....#...#.#.#..#
#######.###.#####.###.#####.#.#####.#.#.#####.#.##
#.........#...#...#.....#...#.#.....#.#.#.#...#..#
###.###.###.###.#.#.#.#.#.#.#######.###.#.#.###.##
#...#.#...#.#...#.#.#.#.#.#.#.......#.#...#.#....#
###.#.#.###.#####.#####.###.###.###.#.#.#######.##
#.....#...#...#.......#.#.#...#.#...#.........#..#
#######.#.#####.#.#.###.#.#.###.###.#.#.###.###.##
#.......#...#...#.#...#.#.....#.#...#.#...#.#....#
#####.#.#.#####.#.#.#.#####.#####.#.###.#.###.#.##
#.....#.#.#.....#.#.#.#.....#.....#.#.#.#...#.#..#
#####.###.###.#.#####.###.###.#.###.#.#.###.###.##
#.....#.....#.#.....#.#.....#.#...#...#...#...#..#
#####.###.#.#.#.###.#.#.#####.#.###.###.#####.#.##
#.......#.#.#.#...#.#.#.#.....#.#.....#...#...#..#
###.#.#.#.#.#.#.#.#.#.#.#.#.#.#.#.#.#.#.#.#.#.#.##
##################################################
