12 11
############
#.#........#
#.#.######.#
#.#....#...#
#.########.#
#...#...#..#
#.#.#.#.#..#
#.#.#.#....#
#.#.#.#.#...
###...#.#...
#####...####