1200 1200
#.###....###
#o#........#
#.#.######.#
#.#....#....
#.###**#.#.#
#...####.#.#
#.#.#....#.#
#.#.#.##.#.#
#o#.#.##.#..
###......#..